80 60
11111111111111111111111111111111111111111111111111111111111111111111111111111111
10000000000110100000000000000000000000000000000000000000000000011111100000000001
10000000000110100000000000000000000000000000000000000000000000000011100000000001
10000000000110100000000000000000000000000000000000000000000000000011100000000001
10000000000110100000000000000000000000000000000000000000000000000011000000000001
10000000000111100000000000000000000000000000000000000000000000000010000000000001
10000000000111100000000000000000000000000000000000000000000000000010000000000001
10000000000111100000000000000000000000000000000000000000000000000010000000000001
10000000000111100000000000000000000000000000000000000000000000000010000000000001
10000000000111100000000000000000000000000000000000000000000000000010000000000001
10000000000011100000000000000000000000000000000000000000000000000010000000000001
10000000000011100000000000000000000000000000000000000000000000000010000000000001
10000000000001100000000000111111111111111111111110000000000000000010000000000001
10000000000001100000000000000000000000000001111111110000000000000010000000000001
10000000000001000000000000000000000000000000000000111000000000000010000000000001
10000000000001000000000000000000000000000000000000011100000000000010000000000001
10000000000001000000000000000000000000000000000000001100000000000010000000000001
10000000000001100000000000000000000000000000000000001100000000000010000000000001
10000000000001100000000000000000000000000000000000001100000000000011100000000001
10000000000000110000000000000000000000000000000000001100000000000011100000000001
10000000000000110000000000000000000000000000000000000100000000000111110000000001
10000000000000111000000000000000000000000000000000000100000000000111110000000001
10000000000001111000000000000000000000000000000000000110000000000111111000000001
10000000000001111000000000000000000000000000000000000110000000000111111000000001
10000000000001111000000000000000000000000000000000000110000000000111111000000001
10000000000001011111000111100111110000000000000000000110000000000011110000000001
10000000000001011000111000111111111111100000000000000110000000000011100000000001
10000000000001011111100011111100000000110000000000000010000000000011100000000001
10000000000001111000000000000000000000011000000000000010000000000001100000000001
10000000000001110000000000000000000000001000000000000010000000000001100000000001
10000000000001100000000000000000000000001100000000000010000000000001000000000001
10000000000001100000000000000000000000000100000000000010000000000001000000000001
10000000000001100000000000000000000000000100000000000010000000000001000000000001
10000000000001000000000000000000000000000100000000000010000000000001000000000001
10000000000001000000000000000000000000000100000000000010000000000001000000000001
10000000000001000000000000000000000000000100000000000010000000000001000000000001
10000000000001000000000000000000000000000100000000000010000000000001000000000001
10000000000001000000000000000000000000000100000000000010000000000001000000000001
10000000000001000000000000000000000000000100000000000010000000000001000000000001
10000000000011000000000000000000000000000100000000000110000000000001000000000001
10000000000011000000000000000000000000000100000000000100000000000001000000000001
10000000000010000000000000000000000000000100000000000100000000000001000000000001
10000000000011000000000000000000000000000100000000000100000000000001000000000001
10000000000001000000000000000000000000000100000000000100000000000001000000000001
10000000000001000000000000100000000000000100000000000100000000000001000000000001
10000000000001000000000000100000000000011100000000000100000000000011000000000001
10000000000000000000000000100000000000111100000000000100000000000011000000000001
10000000000000000000000000100000000000111100000000000100000000000111000000000001
10000000000000000000000000100000000000000000000000000100000000000111100000000001
10000000000000000000000000100000000000000000000000000100000000001111110000000001
10000000000000000000000000100000000000000000000000000100000000000111000000000001
10000000000000000000000001100000000000000000000000000100000000000011000000000001
10000000000000000000000011100000000000000000000000001100000000000000000000000001
10000000000000000000000111100000000000000000000000001000000000000000000000000001
10000000000000000000001111110000000000000000000000011100000000000000000000000001
10000000000000000000011111110000000000000000000000111110000000000000000000000001
11000000000000000000111111111000000000000000000001111111000000000000000000000001
11100000000000000011111111111000000000000000000011111111100000000000000000000011
11111111111111111111111111110110000000000000011111111110110000011001110000000111
11111111111111111111111111111111111111111111111111111111111111111111111111111111
